0   0   0  32  32   0  32   0  32   0	0  32   0   0  32   0   0  32   0  33   0   0   0   0 
0   0   0   0   0   0  26   0   0   0   0   0  32   0   0  19   0   0   0   0   0   0   0   0 
0   0   0   0  20  21   2   0  24   0   0   0   0   0  19  19   0   0   0   0   0   0   0   0    
2   0   0  13  14  15   0  23   2   0   0   0  25  19  19   2  29  30   0   0   0   0   0   0
2   2   0   2   0   0   0   2  32   0	0   0  13  14  15   0   2   2   0   2   2   2   0   2    
2   2   2   2   0   0   2   2   2  25  19  27   0   0   0   0   0   2  31   0   0   0   0   0    
2   2   2   2   2   2   2  17  17   2	2   2   2   2   2   0   2   2   2   2   2   2   2  17       
5   5   5  10   8   5   5  18  19   2	2   2   2   2   2  19   2   2   2   2   2   2   2  18   