0  0  0 32 32 32 32 32 32 32  0 19  0  0  0  0  0 33  0  0  0  0  0  0
0  0  0  0  0  0  2  0  0  0  0  0  0  0  0  0  0  0  0  0  0  0  0  0
2  0  0  0  0  2  0  2  0  0  0 19  0  0  0  0  0  0  0  0  0  0  0 19
2  2  0  0  2  0  0  0  2 19  0  0  0  0  0  0  0  0  0  0 13 14 15  0
2  2  0  2  0  0  0  0  2  2  2  2  0  0  0  0  0  0  0  0  0  0  0  0
2  2  0  0  0  0  0  0 19  0  0 19  0  0  0  2  2  2  2  2  0  0  0  0
2  2 17  2  2  2  2  2  2  2  2  2  2  2  2  2  2  2  2  2 17 17 17 17
2  2 18  2  2  2  2  2  2  2  2  2  2  2  2  2  2  2  2  2 18 18 18 18